smc	Symbiodinium microadriaticum
esi	Ectocarpus siliculosus
pin	Phytophthora infestans
pra	Phytophthora ramorum
psj	Phytophthora sojae
pti	Phaeodactylum tricornutum
xbo	Xenoturbella bocki
bbe	Branchiostoma belcheri
bfl	Branchiostoma floridae
cin	Ciona intestinalis
csa	Ciona savignyi
odi	Oikopleura dioica
pma	Petromyzon marinus
xla	Xenopus laevis
xtr	Xenopus tropicalis
apl	Anas platyrhynchos
cli	Columba livia
gga	Gallus gallus
tgu	Taeniopygia guttata
cfa	Canis familiaris
dno	Dasypus novemcinctus
ocu	Oryctolagus cuniculus
aja	Artibeus jamaicensis
eca	Equus caballus
efu	Eptesicus fuscus
pal	Pteropus alecto
mdo	Monodelphis domestica
meu	Macropus eugenii
sha	Sarcophilus harrisii
age	Ateles geoffroyi
lla	Lagothrix lagotricha
cja	Callithrix jacchus
sbo	Saimiri boliviensis
sla	Saguinus labiatus
mml	Macaca mulatta
mne	Macaca nemestrina
pbi	Pygathrix bieti
pha	Papio hamadryas
mmr	Microcebus murinus
dma	Daubentonia madagascariensis
oga	Otolemur garnettii
ggo	Gorilla gorilla
hsa	Homo sapiens
ppa	Pan paniscus
ppy	Pongo pygmaeus
ptr	Pan troglodytes
ssy	Symphalangus syndactylus
nle	Nomascus leucogenys
lca	Lemur catta
oan	Ornithorhynchus anatinus
cgr	Cricetulus griseus
cpo	Cavia porcellus
mmu	Mus musculus
rno	Rattus norvegicus
bta	Bos taurus
chi	Capra hircus
oar	Ovis aries
tch	Tupaia chinensis
ssc	Sus scrofa
aca	Anolis carolinensis
ami	Alligator mississippiensis
cpi	Chrysemys picta
oha	Ophiophagus hannah
pbv	Python bivittatus
abu	Astatotilapia burtoni
ccr	Cyprinus carpio
dre	Danio rerio
eel	Electrophorus electricus
fru	Fugu rubripes
gmo	Gadus morhua
hhi	Hippoglossus hippoglossus
ipu	Ictalurus punctatus
mze	Metriaclima zebra
nbr	Neolamprologus brichardi
ola	Oryzias latipes
oni	Oreochromis niloticus
pny	Pundamilia nyererei
pol	Paralichthys olivaceus
ssa	Salmo salar
tni	Tetraodon nigroviridis
lva	Lytechinus variegatus
pmi	Patiria miniata
spu	Strongylocentrotus purpuratus
sko	Saccoglossus kowalevskii
isc	Ixodes scapularis
pte	Parasteatoda tepidariorum
rmi	Rhipicephalus microplus
tur	Tetranychus urticae
dpu	Daphnia pulex
mja	Marsupenaeus japonicus
tcf	Triops cancriformis
aae	Aedes aegypti
aga	Anopheles gambiae
ame	Apis mellifera
api	Acyrthosiphon pisum
bdo	Bactrocera dorsalis
bib	Biston betularia
bmo	Bombyx mori
cqu	Culex quinquefasciatus
dan	Drosophila ananassae
der	Drosophila erecta
dgr	Drosophila grimshawi
dme	Drosophila melanogaster
dmo	Drosophila mojavensis
dpe	Drosophila persimilis
dps	Drosophila pseudoobscura
dqu	Dinoponera quadriceps
dse	Drosophila sechellia
dsi	Drosophila simulans
dvi	Drosophila virilis
dwi	Drosophila willistoni
dya	Drosophila yakuba
hme	Heliconius melpomene
lmi	Locusta migratoria
mse	Manduca sexta
ngi	Nasonia giraulti
nlo	Nasonia longicornis
nvi	Nasonia vitripennis
pca	Polistes canadensis
pxy	Plutella xylostella
sfr	Spodoptera frugiperda
tca	Tribolium castaneum
smr	Strigamia maritima
asu	Ascaris suum
bma	Brugia malayi
cbn	Caenorhabditis brenneri
cbr	Caenorhabditis briggsae
cel	Caenorhabditis elegans
crm	Caenorhabditis remanei
hco	Haemonchus contortus
hpo	Heligmosomoides polygyrus
ppc	Pristionchus pacificus
prd	Panagrellus redivivus
str	Strongyloides ratti
cte	Capitella teleta
gpy	Glottidia pyramidata
tre	Terebratulina retusa
hru	Haliotis rufescens
lgi	Lottia gigantea
mle	Melibe leonina
cla	Cerebratulus lacteus
egr	Echinococcus granulosus
emu	Echinococcus multilocularis
fhe	Fasciola hepatica
gsa	Gyrodactylus salaris
mco	Mesocestoides corti
sja	Schistosoma japonicum
sma	Schistosoma mansoni
sme	Schmidtea mediterranea
hma	Hydra magnipapillata
nve	Nematostella vectensis
aqu	Amphimedon queenslandica
lco	Leucosolenia complicata
sci	Sycon ciliatum
ddi	Dictyostelium discoideum
cre	Chlamydomonas reinhardtii
cln	Cunninghamia lanceolata
pab	Picea abies
pde	Pinus densata
pta	Pinus taeda
ppt	Physcomitrella patens
smo	Selaginella moellendorffii
atr	Amborella trichopoda
seu	Salicornia europaea
pgi	Panax ginseng
cca	Cynara cardunculus
han	Helianthus annuus
har	Helianthus argophyllus
hci	Helianthus ciliaris
hex	Helianthus exilis
hpa	Helianthus paradoxus
hpe	Helianthus petiolaris
htu	Helianthus tuberosus
aly	Arabidopsis lyrata
ath	Arabidopsis thaliana
bna	Brassica napus
bol	Brassica oleracea
bra	Brassica rapa
cas	Camelina sativa
cpa	Carica papaya
cme	Cucumis melo
cst	Cucumis sativus
hbr	Hevea brasiliensis
mes	Manihot esculenta
rco	Ricinus communis
aau	Acacia auriculiformis
ahy	Arachis hypogaea
amg	Acacia mangium
gma	Glycine max
gso	Glycine soja
lja	Lotus japonicus
mtr	Medicago truncatula
pvu	Phaseolus vulgaris
vun	Vigna unguiculata
ama	Avicennia marina
dpr	Digitalis purpurea
rgl	Rehmannia glutinosa
smi	Salvia miltiorrhiza
ssl	Salvia sclarea
lus	Linum usitatissimum
gar	Gossypium arboreum
ghb	Gossypium herbaceum
ghr	Gossypium hirsutum
gra	Gossypium raimondii
tcc	Theobroma cacao
eun	Eugenia uniflora
pla	Paeonia lactiflora
aqc	Aquilegia caerulea
bcy	Bruguiera cylindrica
bgy	Bruguiera gymnorhiza
fve	Fragaria vesca
mdm	Malus domestica
ppe	Prunus persica
ccl	Citrus clementina
crt	Citrus reticulata
csi	Citrus sinensis
ctr	Citrus trifoliata
peu	Populus euphratica
ptc	Populus trichocarpa
nta	Nicotiana tabacum
sly	Solanum lycopersicum
stu	Solanum tuberosum
vvi	Vitis vinifera
aof	Asparagus officinalis
ata	Aegilops tauschii
bdi	Brachypodium distachyon
egu	Elaeis guineensis
far	Festuca arundinacea
hvu	Hordeum vulgare
osa	Oryza sativa
sbi	Sorghum bicolor
sof	Saccharum officinarum
ssp	Saccharum sp.
tae	Triticum aestivum
ttu	Triticum turgidum
vca	Vriesea carinata
zma	Zea mays
bfv	Bovine foamy virus
bhv1	Bovine herpesvirus 1
bhv5	Bovine herpesvirus 5
bkv	BK polyomavirus
blv	Bovine leukemia virus
bpcv1	Bandicoot papillomatosis carcinomatosis virus type 1
bpcv2	Bandicoot papillomatosis carcinomatosis virus type 2
dev	Duck enteritis virus
ebv	Epstein Barr virus
gggpv1	Gorilla gorilla gorilla polyomavirus 1
hbv	Herpes B virus
hcmv	Human cytomegalovirus
hhv6b	Human herpesvirus 6B
hiv1	Human immunodeficiency virus 1
hsv1	Herpes Simplex Virus 1
hsv2	Herpes Simplex Virus 2
hvsa	Herpesvirus saimiri strain A11
hvt	Herpesvirus of turkeys
iltv	Infectious laryngotracheitis virus
jcv	JC polyomavirus
kshv	Kaposi sarcoma-associated herpesvirus
mcmv	Mouse cytomegalovirus
mcpv	Merkel cell polyomavirus
mdv1	Mareks disease virus type 1
mdv2	Mareks disease virus type 2
mghv	Mouse gammaherpesvirus 68
prv	Pseudorabies virus
ptvpv2a	Pan troglodytes verus polyomavirus 2a
racpv	Raccoon polyomavirus
rlcv	Rhesus lymphocryptovirus
rrv	Rhesus monkey rhadinovirus
sfv	Simian foamy virus
sv40	Simian virus 40
ttv	Torque teno virus